1111111111111
10010CCC0CCC1
1000011111001
10P0011E00001
1111111111111
